C    		1	,   	4	  ,		1

F  45	  , 43, 44
SO textures/simonkraft/respawn_anchor_side4.xpm
NO textures/simonkraft/respawn_anchor_side0.xpm
WE textures/simonkraft/respawn_anchor_side3.xpm
EA textures/simonkraft/respawn_anchor_side2.xpm




1     11111
1111111111111     11111
1111110001111111111   111111
11111000001111111111111001011
111100000011111111111111111
111000000001111
1100000N0000011
100001111100001
110000111000011
111000010000111
111100000001111
111110000011111
111111000111111
111111111111111111
111111111111111111
1111100011111111
11111111111111
1  1    1101
   1    1101111
   1    1 111





