C    		255	,   	4	  ,		1

F  45	  , 43, 44
SO textures/simonkraft/respawn_anchor_side4.xpm
NO textures/simonkraft/respawn_anchor_side0.xpm
WE textures/simonkraft/respawn_anchor_side3.xpm
EA textures/simonkraft/respawn_anchor_side2.xpm


111111111
10000100111111111111111111
100011001
100000001
100E00011
100000001
111111111





