C    		255	,   	4	  ,		1

F  45	  , 43, 44
SO textures/netherrack_02.xpm
NO textures/netherrack_01.xpm
WE textures/basalt_top.xpm
EA textures/warped_nylium.xpm


1111111111
1000010011
10001 101
101011001
101N10011
101000001
111111111





