SO textures/respawn_anchor_side4.xpm
NO textures/respawn_anchor_side0.xpm
WE textures/respawn_anchor_side3.xpm
EA textures/respawn_anchor_side2.xpm
C 255,4,1
F 45, 43, 44


1111111111111111111111111
1000000000000000000000001
1011111011111110111111101
1000000000000010000000001
1000111111011010111110001
1010100001011010000010101
1010111001011110111011101
1000000000000000000000001
1111111101111110111111111
1000000100000010000000001
1011011101111110111010111
101001010100000N001010001
1011111111011111101111101
1000000000000000000000001
1111111111111111111111111


